C 2,20,30
R  2147483647 2147483647
NO ./textures/eagle.xpm
SO ./textures/greystone.xpm
EA ./textures/red.xpm
WE ./textures/purplestone.xpm

F 2,3,4

1111111111111111111111111111
00000000000000000011000000001
11111111111100000000000010001
10001000000000000000000001001
10110000011100000000000010001
10000000001100000111011110001
11110111111111011100000010001
11110111111111011101010010001
11000000110101011100000010001
10000000000000011000000100011
10000000000000011000100000011
11000000110101000000000000001
11110111110101000000000000001
10000000001100000100000010001
10000000000000000000000001001
100000000010000100000N0001001
10000000001101000000000000001
10000000000100000001010000001
11111111111111111111111111111
